R 1920 1080
NO ./textures/rock_text_1.xpm
SO ./textures/colorstone.xpm
WE ./textures/stone_text_1.xpm
EA ./textures/moshy_text_1.xpm
S1 ./textures/fuego3.xpm
S2 ./textures/fuego4.xpm
F 80, 43, 0
C 0,0,0
111111111111111
100000000000001
100111111111001
1001       1001
1001       1001
1001       1001
100111111111001111111111111111
1000000000E0020000000000000001
111111111111111100111111111001
1              1001       1001
1              1001       1001
1              1001       1001
1              100111111111001
1              100000000000001
111111111111111111111111111111